Oh no!	Oh non!
Get down.	Lâche-toi !
Good job!	Beau travail!
Grab him.	Attrape-le.
Be fair.	Sois équitable !
Come in.	Entre.
I get it.	J'ai compris.
Go away.	Va te faire foutre !
Hang on!	Attends un peu !
He runs.	Il court.
I drive.	Je conduis.
I'm sad.	Je suis triste.
Me, too.	Moi aussi.
Perfect!	Parfait!
See you.	À plus.
Show me.	Montrez-moi !
Shut up!	Taisez-vous!
Who won?	Qui l'a emporté ?
You run.	Tu cours.
Find Tom.	Trouve Tom. _